::: Format of this file: terms-of-the-task :: the outlier-to-find
: all
Aglaya Alexandra Ivan Parfen :: Parfen
Alexandra Aglaya Nastasia Ivan :: Nastasia
Aglaya Alexandra Ivan Lef :: Lef
Ivan Aglaya Gavrila Alexandra :: Gavrila
Aglaya Ivan Afanasy Alexandra :: Afanasy
Aglaya Ardalion Alexandra Ivan :: Ardalion
Ivan Alexandra Marfa Aglaya :: Marfa
Aglaya Vera Ivan Alexandra :: Vera
Nastasia Daria Natalia Parfen :: Parfen
Nastasia Lev Natalia Daria :: Lev
Daria Nastasia Natalia Ivan :: Ivan
Afanasy Daria Natalia Nastasia :: Afanasy
Nastasia Antip Daria Natalia :: Antip
Evgenie Daria Nastasia Natalia :: Evgenie
Nastasia Daria Natalia Alexandr :: Alexandr
Ivolgin Nikitishna Epanchin Sokolovitch :: Nikitishna
Ivolgin Epanchin Philipovna Sokolovitch :: Philipovna
Muishkin Epanchin Ivolgin Sokolovitch :: Muishkin
Ivolgin Borisovna Sokolovitch Epanchin :: Borisovna
Epanchin Sokolovitch Ivolgin Ferdishenko :: Ferdishenko
Rogojin Sokolovitch Epanchin Ivolgin :: Rogojin
Pavlovitch Ivolgin Epanchin Sokolovitch :: Pavlovitch
: location
Petersburg Moscow Tver Gorohovaya :: Gorohovaya
Moscow Tver Petersburg Mattrossky :: Mattrossky
Tver Wladimir Moscow Petersburg :: Wladimir
Petersburg work Tver Moscow :: work
Petersburg fire Tver Moscow :: fire
Switzerland Nativity Paris Pavlofsk :: Nativity
Switzerland Sadovaya Pavlofsk Paris :: Sadovaya
Pavlofsk work Switzerland Paris :: work
Pavlofsk Paris Switzerland fire :: fire
Pavlofsk Switzerland go Paris :: go
